1111111
1110 11
1S00101
1111111