1111111
11111 1
1S00001
1111111