1111111
111 011
1S01001
1111111