111111111111111111111111111111111111111111111111111111111111111111111
100000000000000000000000000000000000000000000000000000000000000000001
101111111111110000111111111111100001111111111111000011111111111110001
101000000000010000100000000000100001000000000001000010000000000010001
101011111110010000101111111010100001011111110101000010111111101010001
10N011111110010000100000001010100001000000010101000010000000101010001
101000000000010000111111101010100001111111010101000011111110101010001
101000000000010000000000001010100000000001010101000000000001001010001
101111111111111111111111111010111111111111010111111111111111111010001
100000000000000000000000000010000000000000010000000000000000000010001
101111111111111111111111111010111111111111010111111111111111111010001
101000000000000000000000001010100000000001010100000000000001000010001
101011111110111111101111101010100001011101010111110111111101111110001
101010000010100000101000001010100001010001010100010100000101000000001
101010111110100000101111101010100001011101010100010111110101011111101
101010000000111111100000001010111110010001011111110000001001000000101
101011111111000000100000000010000010010001000000010000001001111111101
101000000001111111100000011110000010011111000000011000001001000000101
101111111100000000100111100000000010000000001111100011111101111111101
100000000000000000100000000000000010000000000000000000000000000000001
111111111111111111111111111111111111111111111111111111111111111111111
