                            11111111111111
                       11111111000000001111111
                   1111110000000000000000000011111
               111111000000000000000000000000000011111
             1111000000000000000000000000000000000000111
           11110000000000000000000000000000000000000000111
        1111100000000000000000000000000000000000000000000111
        11000000000000000000000000000000000000000000000000111
      1111000000000000000000000000000000000000000000000000111
     110000000000000000000000000000000000000000000000000000111
     1110000000000000000000000000000000000000000000000000000111
   11100000000000000000000000000000000000000000000000000000000111
   11100000000000000000000000000000000000000000000000000000000111
   11100000000000000000000000000000000000000000000000000000000111
  11000000000000000000000000000000000000000000000000000000000000111
1111000000000000000000000000000E000000000000000000000000000000000111
1111000000000000000000000000000000000000000000000000000000000000111
1111000000000000000000000000000000000000000000000000000000000000111
   111000000000000000000000000000000000000000000000000000000001111
   11100000000000000000000000000000000000000000000000000000000111
   11100000000000000000000000000000000000000000000000000000000111
     11100000000000000000000000000000000000000000000000000001111
     1110000000000000000000000000000000000000000000000000000111
       111000000000000000000000000000000000000000000000000111
       111000000000000000000000000000000000000000000000000111
         11100000000000000000000000000000000000000000000111
           1110000000000000000000000000000000000000000111
             111000000000000000000000000000000000000111
               11111000000000000000000000000000011111
                   111110000000000000000000011111
                       1111111000000001111111
                             1111111111