





                    111111111111111111111
                   11000000000000000000011
                   10000000000000000000001
                   10000000000000000000001
                   10000000000000000000001
                   10000000000000000000001
                   10111111111111111111111
                   10000000000000000000001
                   10000000000000000000001
                   10000000000000000000001
                   10000000000000000000001
                  1100000000000000000000011
11111111111111111110000111111111111111000011111111111111111111
1000000000000000000000011            1100000000000000000000001
100000000000000000000001              100000000000000000000001
100000000000000000000001              100000000000000000000001
1000N0000000000000000001              100000000000000000000001
100000000000000000000001              100000000000000000000001
100000000000000000000001              100000000000000000000001
100000000000000000000001              100000000000000000000001
111111111111111111111111              111111111111111111111111
