1111111111111111111
1111111111111111111
11S0000000000001111
1100001000010001111
1100011000010001111
1100000001000001111
1100000001000001111
1111111111111111111
1111111111111111111