111111111111111
1E0001000000001
100001000010001
100011000010001
100000001000001
100000001000001
111111111111111