11111111111111111
11111111111111111
11E00010000000011
11000010000100011
11000110000100011
11000000010000011
11000000010000011
11111111111111111
11111111111111111