
 1111111111111111111111
100000000000S00000000001
 1000000000000000000001
  10000000000000000001
   100000000000000001
    1000000000000001
     10000000000001
      100000000001
       1000000001
        10000001
         100001
          1001
           11